NO textures/Wall_N.xpm
SO textures/Wall_S.xpm
WE textures/Wall_W.xpm
EA textures/Wall_E.xpm

F 128,128,110
C 0,0,70

                                              111111111111111111
                                             10000000000000000001
                                             10000000000000000001
                                             10000000000000000001
 111111111111111111111111111111111111111111111111111000011111111111111111111
10000010000000000000100000000000000100000000000000000000000010000000000000001
10000010000000000000D00000000000000100000000000000000000000010000000000000001
10E000DD000000000000D00000000000000000000000000000000000000000000000000000001
10000010000000000000D00000000000000100000000000000000000000010000000000000001
10000010000000000000100000000000000100000000000000000000000010000000000000001
 111111111111111111111111011111111111111111111111DDD111111111111111111111111
                        101             100000000000000000001
                        101             100000000000000000001
                        111             100000000000000000001
                                         1111111000001111111
                                               1000001
                                                11111
